###########################################################################################
#.........................................................................................#
#.........................................................................................#
#.........................................................................................#
#.........................................................................................#
#.........................................................................................#
#.........................................................................................#
#..........................................................@..............................#
#.........................................................@.@.............................#
#........................................................@...@............................#
#.......................................................@@@@@@@...........................#
#............................................................................@@...........#
#.............................................................................@@..........#
#...........................................................................       .......#
#.......................................H..................................... ...........#
#.........................................................................................#
#.........................................................................................#
#.........................................................................................#
#.........................................................................................#
#.........................................................................................#
#.........................................................................................X
#.........................................................................................#
#.........................................................................................#
#.........................................................................................#
#.........................................................................................#
#.........................................................................................#
#.........................................................................................#
#.........................................................................................#
#.........................................................................................#
###########################################################################################
